abacus|gitorious@git.sugarlabs.org:abacus/mainline.git|Abacus||mainline/|
browse|gitorious@git.sugarlabs.org:browse/mainline.git|Browse|browse-activity|mainline/|
calculate|gitorious@git.sugarlabs.org:calculate/mainline.git|Calculate|calculator-activity|mainline/|
chat|gitorious@git.sugarlabs.org:chat/mainline.git|Chat|chat-activity|mainline/|
clock|gitorious@git.sugarlabs.org:clock/mainline.git|Clock|clock-activity|mainline/|
colors|gitorious@git.sugarlabs.org:colors/mainline.git|Colors|colors-activity|mainline/|
distance|gitorious://git.sugarlabs.org/distance/distance.git|Distance|acoustic-measure-activity|distance/|
etoys|gitorious@git.sugarlabs.org:etoys/mainline.git|Etoys|etoys-activity|mainline/|
finance|gitorious@git.sugarlabs.org:finance/mainline.git|Finance||mainline/|
fototoon|gitorious@git.sugarlabs.org:fototoon/mainline.git|FotoToon||mainline/|
get-books|gitorious@git.sugarlabs.org:get-books/mainline.git|GetBooks||mainline/|
hello-world|gitorious@git.sugarlabs.org:hello-world/mainline.git|||mainline/|
help|gitorious@git.sugarlabs.org:help/mainline.git|Help|help-activity|mainline/|
implode|gitorious@git.sugarlabs.org:implode/mainline.git|Implode||mainline/|
infoslicer|gitorious@git.sugarlabs.org:infoslicer/mainline.git|InfoSlicer||mainline/|
imageviewer|gitorious@git.sugarlabs.org:imageviewer/mainline.git|Imageviewer|imageviewer-activity|mainline/|
jukebox|gitorious@git.sugarlabs.org:jukebox/mainline.git|Jukebox|jukebox-activity|mainline/|
labyrinth|gitorious@git.sugarlabs.org:labyrinth/mainline.git|Labyrinth||mainline/|
log|gitorious@git.sugarlabs.org:log/mainline.git|Log||mainline/|
maze|gitorious@git.sugarlabs.org:maze/mainline.git|Maze||mainline/|
memorize|gitorious@git.sugarlabs.org:memorize/mainline.git|Memorize|memorize|mainline/|
measure|gitorious@git.sugarlabs.org:measure/mainline.git|Measure|measure-activity|mainline/|
moon|gitorious@git.sugarlabs.org:moon/mainline.git|Moon||mainline/|
paint|gitorious@git.sugarlabs.org:paint/mainline.git|Paint|paint/drawing-activity+(oficina)|mainline/|
physics|gitorious@git.sugarlabs.org:physics/mainline.git|Physics|physics-activity|mainline/|
pippy|gitorious@git.sugarlabs.org:pippy/mainline.git|Pippy|pippy-activity|mainline/|
read|gitorious@git.sugarlabs.org:read/mainline.git|Read|read-activity|mainline/|
record|gitorious@git.sugarlabs.org:record/mainline.git|Record|record-activity|mainline/|
ruler|gitorious@git.sugarlabs.org:ruler/mainline.git|Ruler||mainline/|
scratch|gitorious@git.sugarlabs.org:scratch/mainline.git|Scratch|scratch-activity|mainline/|
speak|gitorious@git.sugarlabs.org:speak/mainline.git|Speak|speak-activity|mainline/|
stopwatch|git://git.sugarlabs.org/stopwatch/stopwatch.git|StopWatch|stopwatch-activity|stopwatch/|
tamtam|git://dev.laptop.org/projects/tamtam|TamTam|tamtam-activity|mainline/|
terminal|gitorious@git.sugarlabs.org:terminal/mainline.git|Terminal|terminal-activity|mainline/|
turtleart|gitorious@git.sugarlabs.org:turtleart/mainline.git|Turtleart|turtleart-activity|mainline/|
typing-turtle|gitorious@git.sugarlabs.org:typing-turtle/mainline.git|TypingTurtle||mainline/|
watchme|gitorious@git.sugarlabs.org:watch-me/mainline.git|WatchMe||mainline/|
wikipedia|git://dev.laptop.org/projects/wikiserver|Wikipedia|wikibrowse-activity|wikiserver/|
words|git://git.sugarlabs.org/words-activity/words-activity.git|Words||words-activity/|
write|gitorious@git.sugarlabs.org:write/mainline.git|Write|write-activity+(abiword)|mainline/|
